FullName       -  ShortName
AST            -  AST
AbstractUI     -  ABUI
AlphaEquiv     -  AEQV
Assertions     -  ASSN
Binding        -  BIND
Builder        -  BLDR
Control        -  CNTL
Dev            -  DVPT
Files          -  FILE
FreeVars       -  FVAR
Instantiate    -  INST
Laws           -  LAWS
LexBase        -  LEXB
LiveProofs     -  LPRF
Matching       -  MTCH
Persistence    -  PSST
Proofs         -  PRF
REPL           -  REPL
REqState       -  RQST
Ranking        -  RANK
Sequents       -  SQNT
SideCond       -  SCND
StratifiedDAG  -  SDAG
Substitution   -  SUB
Syntax         -  SYN
TermZipper     -  TZIP
TestParsing    -  TPRS
TestRendering  -  TRND
Theories       -  THRY
Utilities      -  UTIL
VarData        -  VDAT
Variables      -  VAR
WriteRead      -  WRRD
